111111111111
100000000001
100011000001
100010000001
100000000001
111101111001
100000000001
100011001101
1000S0000101
111111111111