111111111111
100000010001
100011000001
100010011E11
100000000001
111101111001
100000000001
100011001101
100000000101
111111111111