1111111111
1000000001
1000110001
1000110001
1000000001
1111011111
1000000001
1000110001
1000000P01
1111111111