111111111111
100000010001
100011011111
100010011S11
100000011111
111101111001
100000000001
100011001101
100000000101
111111111111