F 128, 128, 128
C 153, 204, 255

NO ./textures/mine/north.xpm
SO ./textures/mine/south.xpm
WE ./textures/mine/west.xpm
EA ./textures/mine/east.xpm

1111111111111111111111111111111111111111111111111111111111111111111111111111111111111111
10W1001001001000000000000000000000000000000000000000000000000000000000000000000000000001
1011000001000001000000000000000000000000000000000000000000000000000000000000000000000001
1001001001111101110000000000000000000000000000000000000000000000000000000000000000000001
1001111000001001000000000000000000000000000000000000000000000000000000000000000000000001
1000000000000001000000000000000000000000000000000000000000000000000000000000000000000001
1001111111111001000000000000000000000000000000000000000000000000000000000000000000000001
1111000000000001010000000000000000000000000000000000000000000000000000000000000000000001
1000000001000000000000000000000000000000000000000000000000000000000000000000000000000001
1111111111111111111111111111111111111111111111111111111111111111111111111111111111111111