NO ./textures/mine/north.xpm
SO ./textures/mine/south.xpm
WE ./textures//mine/west.xpm
EA ./textures/mine/east.xpm

F 128, 128, 128
C 153, 204, 255

111111111111111111111
1000000000000000000E1
111111111111111111111
