
													SO ./textures/mine/south.xpm
WE 	./textures/mine/west.xpm

C        153, 204,          											111
EA ./textures/mine/east.xpm
						 F 128, 100, 125

NO ./textures/mine/north.xpm


111111111
100000001
100000001
100000001
1000S0001
100000001
100000001
100000001
111111111