



							SO ./textures/south.xpm
WE						 ./textures/west.xpm

C 				0,           0, 255
EA ./textures/east.xpm

F 128, 128, 128
NO 														./textures/north.xpm
111111111111111111111111111111
100000000000100010000000000101
10000000000000000000000000001
110000000N00000000000000010111
10000000000000100000010000001
11000000000000000000000000011
100000000000000000000000000001
100000000000001000100111111111
1000000011110000001111111 1111
1111111111111111111111111 1111
